Personal Vocabulary - this line will not be parsed
Text: Willkommen zum Experiment. Bevor mit dem Fragebogen begonnen werden kann, gib bitte einige Informationen zu deiner Person an. Diese werden nur zum Zwecke der Analyse genutzt.
Age: Alter
Years: Jahre
Gender: Geschlecht
Male: Männlich
Female: Weiblich
Degree: Abschluss
Bachelor: Bachelor
Master: Master
None: keiner
Other: keiner der genannten
Experience1: Erfahrung mit ExplorViz
Tooltip1: Hilfreicher Text
Experience2: Erfahrung mit ...
Tooltip2: Hilfreicher Text
Experience3: Erfahrung mit...
Tooltip3: Hilfreicher Text
None: Keine
Beginner: Anfänger
Regular: Regelmäßige Nutzung
Advanced: Fortgeschritten
Expert: Experte
Colourblindness: Liegt eine Rot-Grün-Sehschwäche vor?
Yes: Ja
No: Nein
Comment Vocabulary - this line will not be parsed
Difficulty: Schwierigkeitsgrad des Fragebogens (1 = sehr einfach)
Tooltip1: Nützlicher Text
Tutorial: Nützlichkeit des Tutorials (1 = sehr)
Tooltip2: Nützlicher Text
TutorialComment: Anmerkungen zum Tutorial
Email: E-Mail Adresse (nur für Verlosung)
Thankyou: Vielen Dank für die Teilnahme an diesem Experiment